0000000000000
0101010101010
0101012101010
0101010101010
0101000001010
0000010100000
0011000001100
0000010100000
0101011101010
0101010101010
0101010101010
0000000000000
0000000000000